1111111
1000PC1
1010001
1011111
101E111
10101C1
1010101
100C001
10000C1
1111111
