111111111111111111111111111111111111
1P1111C0000000000C1000000000000001E1
1C1100001110000001100011100000000101
101000001111C0000111111C100000000101
1C11100C11111C0001000010100000000101
1000C000111111C0000000000000CC000001
111111111111111111111111111111111111
