1111111111111
10010000000C1
1000011111001
1P00111000001
1111111111111
111111E111111
1111111111111
