111111111111111111
1E000000E000000001
1   01010010010011
101P01001010100111
10000000C000001101
111110000000001111
111111111111111111
